aa	aar	aar
ab	abk	abk
ace	ace	ace
ach	ach	ach
acm	acm	ara
acu	acu	acu
ady	ady	ady
ae	ave	ave
aeb	aeb	ara
af	afr	afr
afb	afb	ara
afh	afh	afh
agr	agr	agr
aii	aii	syr
ain	ain	ain
ajp	ajp	ara
ak	aka	aka
aka	aka	aka
ake	ake	ake
akl	akl	akl
aln	aln	sqi
alt	alt	alt
am	amh	amh
amh	amh	amh
ami	ami	ami
amu	amu	amu
an	arg	arg
ang	ang	ang
anp	anp	anp
aoz	aoz	aoz
apc	apc	ara
ar	ara	ara
ara	ara	ara
arc	arc	arc
arn	arn	arn
arq	arq	ara
ar_TN	ara_TN	ara
ary	ary	ara
arz	arz	ara
as	asm	asm
ase	ase	ase
ast	ast	ast
atj	atj	atj
av	ava	ava
avk	avk	avk
awa	awa	awa
ay	aym	aym
ayl	ayl	ara
aym	aym	aym
az	aze	aze
az_Arab	aze_Arab	aze
azb	azb	aze
az_IR	aze_IR	aze
azz	azz	azz
ba	bak	bak
bal	bal	bal
bam	bam	bam
ban	ban	ban
bar	bar	bar
bas	bas	bas
bcl	bcl	bik
be	bel	bel
bem	bem	bem
ber	ber	ber
be_tarask	bel_tarask	bel
be_x_old	bel_x_old	bel
bfz	bfz	bfz
bg	bul	bul
bg_BG	bul_BG	bul
bh	bih	bih
bho	bho	bho
bi	bis	bis
bjn	bjn	msa
bm	bam	bam
bn	ben	ben
bn_bd	ben_bd	ben
bn_in	ben_in	ben
bn_IN	ben_IN	ben
bnt	bnt	bnt
bo	bod	bod
bod	bod	bod
bom	bom	bom
bpy	bpy	bpy
br	bre	bre
brx	brx	brx
bs	bos	hbs
bs_Cyrl	bos_Cyrl	hbs
bs_Latn	bos_Latn	hbs
bsn	bsn	bsn
bua	bua	bua
bug	bug	bug
bvy	bvy	bvy
bxr	bxr	bua
bzt	bzt	bzt
ca	cat	cat
cak	cak	cak
cat	cat	cat
ca_valencia	cat_valencia	cat
cay	cay	cay
cb	cb	xxx
cbk	cbk	cbk
cbk_zam	cbk_zam	cbk
cdo	cdo	zho
ce	che	che
ceb	ceb	ceb
ch	cha	cha
chg	chg	chg
chn	chn	chn
cho	cho	cho
chq	chq	chq
chr	chr	chr
chv	chv	chv
chy	chy	chy
cjk	cjk	cjk
cjp	cjp	cjp
cjy	cjy	zho
ckb	ckb	kur
ckt	ckt	ckt
cku	cku	cku
cmn	cmn	zho
cmo	cmo	cmo
cnh	cnh	cnh
cni	cni	cni
co	cos	cos
cop	cop	cop
cpi	cpi	cpi
cr	cre	cre
crh	crh	crh
crh_latn	crh_latn	crh
crk	crk	cre
crp	crp	crp
crs	crs	crs
cs	ces	ces
csb	csb	csb
cu	chu	chu
cv	chv	chv
cx	cx	xxx
cy	cym	cym
cycl	cycl	cycl
cyo	cyo	cyo
da	dan	dan
da_DK	dan_DK	dan
dag	dag	dag
de	deu	deu
de_CH	deu_CH	deu
dik	dik	din
din	din	din
diq	diq	zza
dje	dje	dje
djk	djk	djk
dng	dng	dng
dop	dop	dop
drt	drt	drt
dsb	dsb	dsb
dtp	dtp	dtp
dty	dty	nep
dv	div	div
dws	dws	dws
dyu	dyu	dyu
dz	dzo	dzo
ee	ewe	ewe
efi	efi	efi
egl	egl	egl
el	ell	ell
eml	eml	eml
emx	emx	emx
en	eng	eng
en_AU	eng_AU	eng
en_ca	eng_ca	eng
en_CA	eng_CA	eng
en_gb	eng_gb	eng
en_GB	eng_GB	eng
enm	enm	enm
en_NZ	eng_NZ	eng
en_US	eng_US	eng
en_za	eng_za	eng
en_ZA	eng_ZA	eng
eo	epo	epo
es	spa	spa
es_ar	spa_ar	spa
es_AR	spa_AR	spa
es_cl	spa_cl	spa
es_CL	spa_CL	spa
es_CO	spa_CO	spa
es_CR	spa_CR	spa
es_DO	spa_DO	spa
es_EC	spa_EC	spa
es_ES	spa_ES	spa
es_GT	spa_GT	spa
es_HN	spa_HN	spa
es_mx	spa_mx	spa
es_MX	spa_MX	spa
es_NI	spa_NI	spa
es_PA	spa_PA	spa
es_PE	spa_PE	spa
es_PR	spa_PR	spa
es_SV	spa_SV	spa
es_UY	spa_UY	spa
es_VE	spa_VE	spa
et	est	est
eu	eus	eus
evn	evn	evn
ext	ext	ext
fa	fas	fas
fa_IR	fas_IR	fas
ff	ful	ful
fi	fin	fin
fil	fil	fil
fj	fij	fij
fkv	fkv	fkv
fo	fao	fao
fon	fon	fon
foo	foo	xxx
fr	fra	fra
fr_BE	fra_BE	fra
fr_ca	fra_ca	fra
frm	frm	frm
fro	fro	fro
frp	frp	frp
frr	frr	frr
fuc	fuc	ful
ful	ful	ful
fur	fur	fur
fuv	fuv	ful
fy	fry	fry
fy_nl	fry_nl	fry
ga	gle	gle
gaa	gaa	gaa
gag	gag	gag
ga_ie	gle_ie	gle
gan	gan	zho
gbi	gbi	gbi
gbm	gbm	gbm
gcf	gcf	gcf
gcr	gcr	gcr
gd	gla	gla
gil	gil	gil
gl	glg	glg
glk	glk	glk
gn	grn	grn
gom	gom	kok
gor	gor	gor
gos	gos	gos
got	got	got
gr	ell	ell
grc	grc	grc
gsw	gsw	gsw
gu	guj	guj
guc	guc	guc
gu_in	guj_in	guj
guw	guw	guw
gv	glv	glv
ha	hau	hau
hai	hai	hai
hak	hak	zho
hau	hau	hau
haw	haw	haw
hax	hax	hai
haz	haz	haz
hb	hb	xxx
hbo	hbo	hbo
hbs	hbs	hbs
hch	hch	hch
hdn	hdn	hai
he	heb	heb
hi	hin	hin
hif	hif	hif
hi_in	hin_in	hin
hi_IN	hin_IN	hin
hil	hil	hil
hne	hne	hne
hnj	hnj	hmn
ho	hmo	hmo
hoc	hoc	hoc
hr	hrv	hbs
hrx	hrx	hrx
hsb	hsb	hsb
hsn	hsn	zho
ht	hat	hat
hu	hun	hun
hup	hup	hup
hus	hus	hus
hy	hye	hye
hy_am	hye_am	hye
hye	hye	hye
hyw	hyw	hyw
hz	her	her
ia	ina	ina
iba	iba	iba
ibo	ibo	ibo
id	ind	msa
ie	ile	ile
ig	ibo	ibo
igs	igs	igs
ii	iii	iii
ik	ipk	ipk
ike	ike	iku
ilo	ilo	ilo
inh	inh	inh
io	ido	ido
iro	iro	iro
is	isl	isl
it	ita	ita
it_IT	ita_IT	ita
iu	iku	iku
ixl	ixl	ixl
izh	izh	izh
ja	jpn	jpn
jak	jak	msa
jam	jam	jam
jap	jaa	jaa
jbo	jbo	jbo
jdt	jdt	jdt
jiv	jiv	jiv
jp	jpn	jpn
jpa	jpa	jpa
jv	jav	jav
ka	kat	kat
kaa	kaa	kaa
kab	kab	kab
kac	kac	kac
kam	kam	kam
kar	kar	kar
kau	kau	kau
kbd	kbd	kbd
kbh	kbh	kbh
kbp	kbp	kbp
kcg	kcg	kcg
kea	kea	kea
kek	kek	kek
kg	kon	kon
kha	kha	kha
ki	kik	kik
kik	kik	kik
kin	kin	kin
kiu	kiu	zza
kj	kua	kua
kjh	kjh	kjh
kk	kaz	kaz
kl	kal	kal
klj	klj	klj
km	khm	khm
kmb	kmb	kmb
kmr	kmr	kur
kn	kan	kan
knc	knc	kau
ko	kor	kor
koi	koi	kom
kon	kon	kon
kpv	kpv	kom
kr	kau	kau
kr_Arab	kau_Arab	kau
krc	krc	krc
krl	krl	krl
kr_Latn	kau_Latn	kau
ks	kas	kas
ks_Arab	kas_Arab	kas
ks_Deva	kas_Deva	kas
ksh	ksh	ksh
ku	kur	kur
ku_Arab	ckb	kur
ku_Latn	kmr	kur
kum	kum	kum
kv	kom	kom
kw	cor	cor
kxi	kxi	kxi
ky	kir	kir
kzj	dtp	dtp
la	lat	lat
laa	laa	laa
lad	lad	lad
lb	ltz	ltz
lbe	lbe	lbe
ldn	ldn	ldn
lez	lez	lez
lfn	lfn	lfn
lg	lug	lug
li	lim	lim
lij	lij	lij
lin	lin	lin
liv	liv	liv
lkt	lkt	lkt
lld	lld	lld
lmo	lmo	lmo
ln	lin	lin
lo	lao	lao
lou	lou	lou
lrc	lrc	lrc
lt	lit	lit
ltg	ltg	lav
lu	lub	lub
lua	lua	lua
luo	luo	luo
lus	lus	lus
lut	lut	lut
luy	luy	luy
lv	lav	lav
lzh	lzh	zho
lzz	lzz	lzz
mad	mad	mad
mag	mag	mag
mai	mai	mai
mam	mam	mam
map_bms	map_bms	map
max	max	msa
mdf	mdf	mdf
me	cnr	hbs
me_Cyrl	cnr_Cyrl	hbs
meh	meh	meh
me_Latn	cnr_Latn	hbs
mfa	mfa	msa
mfe	mfe	mfe
mg	mlg	mlg
mgm	mgm	mgm
mh	mah	mah
mhr	mhr	chm
mi	mri	mri
mic	mic	mic
mik	mik	mik
min	min	msa
mix	mix	mix
mk	mkd	mkd
ml	mal	mal
mlg	mlg	mlg
mn	mon	mon
mnc	mnc	mnc
mni	mni	mni
mnr	mnr	mnr
mnw	mnw	mnw
mo	mol	ron
moh	moh	moh
mos	mos	mos
mr	mar	mar
mrj	mrj	chm
ms	msa	msa
ms_MY	msa_MY	msa
mt	mlt	mlt
mus	mus	mus
mvv	mvv	mvv
mwl	mwl	mwl
mww	mww	hmn
my	mya	mya
myv	myv	myv
mzn	mzn	mzn
na	nau	nau
nah	nah	nah
nan	nan	zho
nap	nap	nap
nb	nob	nor
nb_no	nob_no	nor
nb_NO	nob_NO	nor
nch	nch	nch
nci	nci	nci
nd	nde	nde
nds	nds	nds
nds_nl	nds_nl	nds
ne	nep	nep
ne_np	nep_np	nep
new	new	new
ngt	ngt	ngt
ngu	ngu	ngu
nhg	nhg	nhg
nhn	nhn	nhn
nia	nia	nia
niu	niu	niu
nl	nld	nld
nl_BE	nld_BE	nld
nlv	nlv	nlv
nn	nno	nor
nnb	nnb	nnb
nn_no	nno_no	nor
nn_NO	nno_NO	nor
no	nor	nor
nog	nog	nog
non	non	non
no_nb	nor_nb	nor
nov	nov	nov
npi	npi	nep
nqo	nqo	nqo
nr	nbl	nbl
nrm	nrm	nrm
ns	ns	xxx
nso	nso	nso
nst	nst	nst
nus	nus	nus
nv	nav	nav
ny	nya	nya
nya	nya	nya
nys	nys	nys
oar	oar	oar
oc	oci	oci
ofs	ofs	ofs
oj	oji	oji
ojb	ojb	oji
olo	olo	olo
om	orm	orm
ood	ood	ood
or	ori	ori
orm	orm	orm
orv	orv	orv
os	oss	oss
osp	osp	osp
osx	osx	osx
ota	ota	ota
otk	otk	otk
pa	pan	pan
pag	pag	pag
pai	pai	pai
pa_in	pan_in	pan
pal	pal	pal
pam	pam	pam
pan	pan	pan
pap	pap	pap
pau	pau	pau
pcd	pcd	pcd
pck	pck	pck
pcm	pcm	pcm
pdc	pdc	pdc
pes	pes	fas
pfl	pfl	pfl
phn	phn	phn
pi	pli	pli
pih	pih	pih
pl	pol	pol
plt	plt	mlg
pms	pms	pms
pnb	pnb	lah
pnt	pnt	pnt
po	po	xxx
pot	pot	pot
ppk	ppk	ppk
ppl	ppl	ppl
prg	prg	prg
prs	prs	fas
ps	pus	pus
pt	por	por
pt_br	por_br	por
pt_BR	por_BR	por
pt_PT	por_PT	por
qa	qa	xxx
qd	qd	xxx
qu	que	que
quc	quc	quc
que	que	que
quw	quw	que
quy	quy	que
quz	quz	que
qvi	qvi	que
qxq	qxq	qxq
qya	qya	qya
rap	rap	rap
rel	rel	rel
rhg	rhg	rhg
rif	rif	rif
rm	roh	roh
rm_sursilv	roh_sursilv	roh
rm_vallader	roh_vallader	roh
rmy	rmy	rom
rn	run	run
ro	ron	ron
roa_tara	roa_tara	roa
rom	rom	rom
ru	rus	rus
rue	rue	rue
run	run	run
rup	rup	rup
rw	kin	kin
ry	ry	xxx
ryu	ryu	ryu
sa	san	san
sah	sah	sah
sat	sat	sat
sc	srd	srd
scc	srp	hbs
scn	scn	scn
sco	sco	sco
scr	hrv	hbs
sd	snd	snd
sdh	sdh	kur
se	sme	sme
ses	ses	ses
sg	sag	sag
sgn	sgn	sgn
sgs	sgs	sgs
sh	hbs	hbs
shi	shi	shi
shn	shn	shn
shs	shs	shs
shy	shy	shy
si	sin	sin
simple	eng-simple	eng
sjn	sjn	sjn
sk	slk	slk
skr	skr	lah
sl	slv	slv
sm	smo	smo
sma	sma	sma
smn	smn	smn
sn	sna	sna
sna	sna	sna
so	som	som
som	som	som
son	son	son
sot	sot	sot
sq	sqi	sqi
sr	srp	hbs
sr_Cyrl	srp_Cyrl	hbs
sr_Latn	srp_Latn	hbs
sr_ME	srp_ME	hbs
srn	srn	srn
srp	srp	hbs
ss	ssw	ssw
st	sot	sot
stq	stq	stq
su	sun	sun
sux	sux	sux
sv	swe	swe
sv_se	swe_se	swe
sw	swa	swa
swa	swa	swa
swc	swc	swa
swg	swg	swg
swh	swh	swa
syc	syc	syc
syl	syl	syl
syr	syr	syr
sz	sz	xxx
szl	szl	szl
szy	szy	szy
ta	tam	tam
taq	taq	tmh
tc	tc	xxx
tcy	tcy	tcy
te	tel	tel
tet	tet	tet
tg	tgk	tgk
tg_TJ	tgk_TJ	tgk
th	tha	tha
thv	thv	tmh
ti	tir	tir
tig	tig	tig
tir	tir	tir
tk	tuk	tuk
tkl	tkl	tkl
tl	tgl	tgl
tlh	tlh	tlh
tl_PH	tgl_PH	tgl
tly	tly	tly
tmh	tmh	tmh
tmp	tyj	tyj
tmr	tmr	tmr
tmw	tmw	msa
tn	tsn	tsn
to	ton	ton
toi	toi	toi
tok	tok	tok
toki	toki	tok
tpi	tpi	tpi
tpw	tpw	tpw
tr	tur	tur
trs	trs	trs
tr_TR	tur_TR	tur
trv	trv	trv
ts	tso	tso
tsz	tsz	tsz
tt	tat	tat
tts	tts	tts
tum	tum	tum
tvl	tvl	tvl
tw	twi	aka
ty	tah	tah
tyv	tyv	tyv
tz	tz	xxx
tzl	tzl	tzl
tzm	tzm	tzm
udm	udm	udm
ug	uig	uig
uk	ukr	ukr
umb	umb	umb
ur	urd	urd
urh	urh	urh
ur_PK	urd_PK	urd
usp	usp	usp
uz	uzb	uzb
ve	ven	ven
vec	vec	vec
vep	vep	vep
vi	vie	vie
vi_VN	vie_VN	vie
vls	vls	vls
vo	vol	vol
vot	vot	vot
vro	vro	est
wa	wln	wln
wal	wal	wal
war	war	war
wo	wol	wol
wol	wol	wol
wuu	wuu	zho
xal	xal	xal
xcl	xcl	xcl
xh	xho	xho
xho	xho	xho
xmf	xmf	xmf
xnz	xnz	xnz
xqa	xqa	xqa
yaq	yaq	yaq
yi	yid	yid
yo	yor	yor
yor	yor	yor
yua	yua	yua
yue	yue	zho
za	zha	zha
zam	zam	zap
zea	zea	zea
ze_en	eng	eng
ze_zh	zho	zho
zgh	zgh	zgh
zh	zho	zho
zh_cn	zho_cn	zho
zh_CN	zho	zho
zh_en	zho_en	zho
zh_hant	zho_hant	zho
zh_hk	zho_hk	zho
zh_HK	zho_HK	zho
zhs	zho	zho
zht	zho	zho
zh_tw	zho_tw	zho
zh_TW	zho	zho
zh_yue	zho_yue	zho
zh_zh	zho_zh	zho
zlm	zlm	msa
zsm	zsm	msa
zu	zul	zul
zul	zul	zul
zz	zz	xxx
zza	zza	zza
